{
  "element1": [
    [0,0],
    [ 
      "00000000000000000000000000000000",
      "00000000000000000000000000000000",
      "000000000000000000000000000c0000",
      "00000000000000000000000b00000000",
      "00000000000000000000000000000000",
      "00000000000000000000000000000000",
      "00000000000000000000000000000000",
      "00000000000000000000000000000000",
      "00000000000000000000000000000000",
      "00000000000000000000000000000000",
      "00000000000000000000000000000000",
      "00000000000000000000000000000000",
      "00000000000000000000000000000000",
      "00000000000000000000000000000000",
      "0000abbc0000000000000000000000000",
      "abbbeeeebbbbbbbbbbbbbbbbbbbbbbbc",
      "deeeeeeeeeeeeeeeeeeeeeeeeeeeeeef",
      "deeeeeeeeeeeeeeeeeeeeeeeeeeeeeef",
      "deeeeeeeeeeeeeeeeeeeeeeeeeeeeeef",
      "ghhhhhhhhhhhhhhhhhhhhhhhhhhhhhhi"
    ]],
    "element2": [
    [0,32],
    [ 
      "00000000000000000000000000000000",
      "00000000000000000000000000000000",
      "000000000000000000000000000c0000",
      "00000000000000000000000b00000000",
      "00000000000000000000000000000000",
      "00000000000000000000000000000000",
      "00000000000000000000000000000000",
      "00000000000000000000000000000000",
      "00000000000000000000000000000000",
      "00000000000000000000000000000000",
      "00000000000000000000000000000000",
      "00000000000000000000000000000000",
      "00000000000000000000000000000000",
      "00000000000000000000000000000000",
      "0000abbc0000000000000000000000000",
      "abbbeeeebbbbbbbbbbbbbbbbbbbbbbbc",
      "deeeeeeeeeeeeeeeeeeeeeeeeeeeeeef",
      "deeeeeeeeeeeeeeeeeeeeeeeeeeeeeef",
      "deeeeeeeeeeeeeeeeeeeeeeeeeeeeeef",
      "ghhhhhhhhhhhhhhhhhhhhhhhhhhhhhhi"
    ]]
}

