{
  "level1": [
    [0, 0, 0, 0, 0, 0 ,0 ,0 ,0, 0, 0 ,0, 0 , 0],
    [0, 0, 0, 0, 0, 0 ,0 ,0 ,0, 0, 0 ,0, 0 ,0 ],
    [0, 0, 0, 0, 0, 0 ,0 ,0 ,0, 0, 0 ,0, 0 ,0 ],
    [0, 0, 0, 0, 0, 0 ,0 ,0 ,0, 0, 0 ,0, 0 ,0 ],
    [0, 0, 0, 0, 0, 0 ,0 ,0 ,0, 0, 0 ,0, 0 ,0 ],
    [0, 0, 0, 0, 0, 0 ,0 ,0 ,0, 0, 0,0, 0 ,0 ],
    [0, 0, 0, 4, 2, 2 ,2 ,2 ,2, 2, 8 ,0, 0 , 0],
    [0, 0, 0, 9, 6, 6 ,6 ,6 ,6, 6, 13 ,0, 0 ,0 ],
    [0, 0, 0, 9, 6, 6 ,6 ,6 ,6, 6, 13 ,0, 0 ,0 ]
    
    
  ]
}
